###A###
### ###
###  ##
####  #
###B ##